associations|cleanKeyword=associations
associationsas|cleanKeyword=associationsas
circumstantial|cleanKeyword=circumstantial
circumstantial|cleanKeyword=circumstantial
circumstantialities|cleanKeyword=circumstantialities
circumstantiality|cleanKeyword=circumstantiality
circumstantiallity|cleanKeyword=circumstantiallity
circumstantially|cleanKeyword=circumstantially
circumstantital|cleanKeyword=circumstantital
clang-associations|cleanKeyword=clang-associations
coherence|cleanKeyword=coherence
coherency|cleanKeyword=coherency
coherent|cleanKeyword=coherent
coherently|cleanKeyword=coherently
derail|cleanKeyword=derail
derailed|cleanKeyword=derailed
derailiment|cleanKeyword=derailiment
derailing|cleanKeyword=derailing
derailment|cleanKeyword=derailment
derailment-|cleanKeyword=derailment-
derailments|cleanKeyword=derailments
derails|cleanKeyword=derails
flight of idea|cleanKeyword=flight_of_idea
flight of ideas|cleanKeyword=flight_of_ideas
flight of ideation|cleanKeyword=flight_of_ideation
flights of idea|cleanKeyword=flights_of_idea
Flights of ideas|cleanKeyword=Flights_of_ideas
Form-coherent|cleanKeyword=Form-coherent
incoherence|cleanKeyword=incoherence
Incoherent|cleanKeyword=Incoherent
incoherently|cleanKeyword=incoherently
tangent|cleanKeyword=tangent
tangental|cleanKeyword=tangental
Tangential|cleanKeyword=Tangential
tangentiality|cleanKeyword=tangentiality
tangentiallity|cleanKeyword=tangentiallity
tangentially|cleanKeyword=tangentially
tangentialty|cleanKeyword=tangentialty
tangentianality|cleanKeyword=tangentianality
tangentile|cleanKeyword=tangentile
tangents|cleanKeyword=tangents
FTD|cleanKeyword=FTD|TargetKeyword=yes
poverty of thought|cleanKeyword=poverty_of_thought
poverty of thought-|cleanKeyword=poverty_of_thought
poverty of thoughts|cleanKeyword=poverty_of_thought
thought block|cleanKeyword=thought_block|TargetKeyword=yes
thought blocked|cleanKeyword=thought_block|TargetKeyword=yes
thought block-|cleanKeyword=thought_block|TargetKeyword=yes
thought blocking|cleanKeyword=thought_blocking|TargetKeyword=yes
thought blockings|cleanKeyword=thought_blocking|TargetKeyword=yes
thought disorder|cleanKeyword=thought_disorder|TargetKeyword=yes
thoughts disorder|cleanKeyword=thought_disorder|TargetKeyword=yes
thoughts disordered|cleanKeyword=thought_disorder|TargetKeyword=yes
thought disorders|cleanKeyword=thought_disorder|TargetKeyword=yes